# Configuração do Mapa do Jogo
TILESET tileset.png 7 114 57

# Define quais tiles da imagem são caminháveis.
WALKABLE 1 2

# Define os itens do mapa
ITEMS 3
100 7 2
100 1 12
200 13 13

# Define o grid do mapa
MAP 15 15
0 0 0 0 0 0 0 0 0 0 0 0 0 0 0
0 1 1 1 0 1 1 1 1 1 0 1 1 1 0
0 1 0 1 0 1 0 0 0 1 0 1 0 1 0
0 1 0 1 1 1 1 1 1 1 1 1 0 1 0
0 1 0 0 0 0 0 1 0 0 0 1 0 1 0
0 1 1 1 1 1 0 1 1 1 1 1 0 1 0
0 0 0 0 0 1 0 1 0 1 0 1 0 1 0
0 1 1 1 1 1 1 1 0 1 0 1 1 1 0
0 1 0 1 0 0 0 0 0 1 0 0 0 1 0
0 1 0 1 1 1 1 1 1 1 1 1 1 1 0
0 1 0 0 0 1 0 1 0 1 0 0 1 0 0
0 1 1 1 1 1 0 1 1 1 0 1 1 1 0
0 1 0 0 0 0 0 0 0 1 0 1 0 1 0
0 2 2 2 2 2 2 2 2 2 2 2 2 1 0
0 0 0 0 0 0 0 0 0 0 0 0 0 0 0